1 | 1 | 101 | FREE | 1 | AIRCONDITION*WIFI
2 | 1 | 102 | FREE | 2 | WIFI
3 | 2 | 201 | FREE | 5 | WIFI
4 | 2 | 202 | FREE | 4 | WIFI
5 | 3 | 301 | FREE | 5 | WIFI
6 | 3 | 302 | OCCUPIED | 6 | WIFI
7 | 2 | 203 | FREE | 3 | WIFI
