1 | 1 | 101 | FREE | 1
2 | 1 | 102 | FREE | 2
3 | 2 | 201 | FREE | 5
4 | 2 | 202 | FREE | 4
5 | 3 | 301 | FREE | 5
6 | 3 | 302 | FREE | 6
7 | 2 | 203 | FREE | 3
